sgRNA	gene
ACAGCGTAGTGCAAAACAG	Wwtxj
GACGTCATTCACTGTGAAG	Qmin
TGTTGATGAAGGTGCACCCG	Xlgrb0
GGGGTCCACCGATAACCGGGAGG	Ndxe95
ATGGTGTCACAATTTGTGA	Gcarf81
CGGCACTCGCGCCGGAACGAGGG	Wotwb
GACTTCCACCTCCCAGTAG	Ffptj62
CTGGTGCAAAAGCCCCTCTCGGG	Kgfdvu
CAGTCGTTTCTTATGGCAA	Yaczvxn
ACAGTTACCTTTCCACCATA	Nisw8
GGAAACCTCCCCACCCCAGA	Yaczvxn
TGTCTAGAAGCAGTGCCAAG	Urva39
GAAACAGAATTTCATAAGA	Zbzwj9
GATTCTGTCCTAGATCCCAG	Jcjgmqa90
TCTGGTCCAGGTTGCGGAAG	Hpidfa
GAAATACCTGATCATCCCTG	Wwtxj
GAGCACCTAAAAGTCAGAT	Qoeg
TCAACTCCTTGTTATACACC	Kwznvd80
CGTGTGTAAAGACAAGAGA	Xvwuz
GTTATTGGATCCCACTCAGA	Eflp15
GAAAGGTCCATCAGAGAAG	Gvqti8
AAGTTGGCACACCACCTACA	Wotwb
GCATACTACGTGCAGGAGCA	Ldlb35
CGACACATGGACAGCACGG	Vfxncrp0
CTCCTCACCCAGCAACTCG	Qysdhnf8
TTACTAGGTGGATATGCAGT	Kwznvd80
TGCTAGGGACACCCAAGTCA	Ewlc8
TGTAAGGGCGCAAACCACTGAGG	Kmlp4
AACTTGATGTTCTTAGAAGA	Sjlkqgb
AGGATCGTAATCTATGGCAA	Gvszgh8
AGTGTGGAGACGGAACGCGA	Uieqtrb
CGGCTCGAGACGCGGGAAT	Yfijg5
CCACACAGGCCGGCGTGTC	Urva39
GTGGTTTGTGAAATAATCATGGG	Husam49
ACAGCCGCCAGGAGCTACTC	Jbxdtih9
TCTGCTGATGGTGGTGATGA	Hrazgjq47
AGTTCTGACAGTGACACTGA	Wwtxj
CCTGCTCAGCGCCTACGGCG	Hrazgjq47
GGATCGAGATGGAGCCCAAG	Xvmyqf
TGTTGGCTACAACTATGAG	Hstki
CCCGGAATCGTGTGCTGGGC	Xvwuz
GCTCTTACCACGGTGGTGTT	Wuacgws
TGCCAGGATCTTACCTTGCGAGG	Pcauhol9
CGGGTCTGCGGTAATCCAGCCGG	Rkcfows80
TTAGGTACTACTCCAGCCTT	Qeim
GCGCAGGACGAAGGTGAAGC	Wotwb
GTTGTCACTCTCATACGCA	Xlgrb0
AATCTCGCTCCCTACCGACA	Gvqti8
GGATACCCTGATGGAGTATT	Gsle9
TATGGCAATATTCGAGCTG	Juast
GAATGAGCTACGCAAGCGCC	Bxltvfh82
CGGGTACAATAGATGTCCC	Heko15
GGTACGCTTGGTTTTGATGG	Rhbmcui
GGGCATGGAGGAGAAGGCGG	Jzaqrh
GATGCCTATATTTCTCGATGAGG	Hwxmbru
ACTGTGTCTGCCAGAAGGCG	Rtfgbkn1
GTGGCAGCAGCTGCCTCAAG	Zjrw
GCTTCTTGTTTCCCAAAATC	Yfijg5
TCTCCGACAAGCTGAGCACC	Nisw8
CTTCCCAAAATAGAAATAG	Gcarf81
TTATGAGGGGGTACTCAGAGTGG	Zjozemv6
AACCGAGAAAAGAAGCCAG	Vfxncrp0
TTCGGGCCAGAGCCTGCCAG	Kmlp4
CTCGTAGGCGGCCTTGATGC	Jzaqrh
AGAGGGCACCACGAAAAGTG	Sjlkqgb
CTGAGTTACGGCTAAGATG	Bqtk19
GTCCCCCTTGTCGACTCCGA	Jcjgmqa90
GCGTTTCTATCCGGCTCTGC	Qmin
CTTGCATAATTGCCGCTCT	Jzaqrh
AACACCAGAGGTCACACACG	Mdrpz7
ATCCTGTCTCGGATTGTGGG	Xvwuz
AGCCAGAGACTGAGAGCCAG	Eflp15
AAGAAATGCTGACAGGCCAG	Jcjgmqa90
CAGGAGGCGGAACCAGACGG	Urva39
TACAGCTGCTCTTGAAACG	Qeytcm36
CTGGTGGTCCAGCTCGTGGG	Hwxmbru
GTCGATATTTAACAACGGG	Itvfs
GTTCTATCCCCCCGGGTGC	Hrazgjq47
GTGTCAAGTCCAAACCCATC	Fzwc6
AGTTCTTCTACTCCAGCCT	Rkcfows80
TTCTTCCGAACGGGGGTCC	Zjozemv6
CTAAAAGCTTTCCAACACACAGG	Ykqrp7
TAGTGGATGCTCGAGACTC	Jcjgmqa90
ACAGCAGCGTCTCTCGAGT	Zcfxwy
TAGGTTTAAACACACTTGAG	Ykqrp7
GCCGGAAGGGTACATACCG	Hstki
CGTCGTCAACCCTCAGAGCA	Zexgq29
GAAGAGTGCTGCTTACTCCCAGG	Xlgrb0
TCGTACCTGAGCATGGACG	Nhwzt
AATTTCACACTGCCACCGT	Urva39
TCAATGATGACTTCTAGTTT	Qxwg6
GAGAAGCACATCAGCGAGC	Qeytcm36
GGAAAGACTGTCCTGAACAA	Yfijg5
AGTCGTGACCAGGATGTAGTAGG	Meuxsq3
GTCCGCCTCTAGCTCGAGTA	Rhbmcui
GAAGAAGTACTCAGGAGGTG	Nhwzt
AGCTGAGTTACCAACGAAG	Juast
AGATGCCACTGTGGTTGAAG	Wuacgws
GCCACCCATAAGCTACGAGGAGG	Nisw8
GGCGGCCTGTTGGGGTAGAG	Enht2
GAAAATCAATATCCAATAAA	Dwklva21
TTGTTTCATTATGCCCGAGCTGG	Ndxe95
GTCTGTGCACTCGGCCCACC	Yqhuvtw4
ACACAGAAGTCATGCGAAG	Jsakmu
TCATTCGCAACCTGTAGGG	Husam49
CTCGCTAGTGCTGCGCGAGG	Urva39
GTTCCAGGTCGGCTGTCCAA	Ymhtq
CAATGACCACCATAAGCTGA	Qysdhnf8
GGAGCTGCTGACCACCCTG	Vkxipvz0
ACTCATCAGAGAGATCAGCC	Vfxncrp0
TCTTGAACAGGAAATTTGAG	Hrazgjq47
ATCCACAGGGTCCGTGCAGG	Bxltvfh82
CAGGACCTCAGTCCTGAAG	Jbxdtih9
AGTGGCCAGCGAGATCATGGCGG	Qmin
AGGTGATCGAACTGGGCGCG	Gsle9
AGTTGAGCCATTAAAGGAG	Fzwc6
CAGGGTCCCCAGGCCTTAAA	Zbzwj9
GCTGGGCCGGAAAGAAGAAG	Qeim
GGCCCAGAAGTTACTGCAGA	Hwxmbru
CGATCTCCTCCATCTTCCCG	Qeytcm36
CCTCTTTCACCTCACTTTGT	Sjlkqgb
TCACCCGTGGGGGACCCTACTGG	Ozxvfe04
TGGAGTACGCTCAGCAGCGC	Dwklva21
GTAGTCAACCCCCTTGTCTA	Wwtxj
GAGTATGGTCCTGGTGTTCA	Gvqti8
CAGCACATATGAAGCATAG	Rpun
AAACGGAGGTTCTTCAGAAG	Qldbrk39
TCTGCAATGGGGGTCACCCAGGG	Hpqy6
ATCGCCAAGATAATCACCAA	Jbpa76
GGATAGAACCAACCATGTTG	Gcarf81
GGCTCTCTATTAGAATCAGA	Vzjlgte58
TACGACCGTCTGCGCCGCCC	Ymhtq
CAGTGGCTTGGTCTTCACGG	Yfijg5
GGCACCGAACTGGAACTGA	Jzaqrh
GGTCCGGCCACGCAATGCA	Zexgq29
TCCACCATGGAGCTCCTGCG	Wotwb
ATTTCCACAGATCCGGAACATGG	Rsbq0
GAAGGCACCTCAAATAAAGG	Vkxipvz0
GGTGGTGTGTGGCTATGGTG	Juast
AGGTCCTGCCCAGCAGCGG	Qysdhnf8
AAGCTCATTCAAGAAAAAA	Heko15
GTAGAGTTTATAGAGGTAGGGGG	Hpidfa
GTCGGTCGAAGAAATACTCG	Jcjgmqa90
GAAGATGGCGGACGCGGCCG	Nhwzt
GTTAGGTCCCTTGAGCAAG	Gvqti8
AACCTCCATCCTGTGAGCCC	Wsyazg
GGTCAGCTGATTCCTTCCCT	Pzyiw8
GGGTGCCTTGAAGAGAGTTG	Ymhtq
TGACGTGCAACTCAAAGACC	Fxsq75
CCCTGGGTCCAGGCCGCCG	Meuxsq3
GTGGGACAGGCTATGGCATT	Enht2
GCAGAAACACTTTCACGTA	Qldbrk39
CCCTAGGACTAAAAAGCAAA	Urva39
CAACAACCAGCAGAATGCCG	Fmhctyb
AGAAACTTTGTGAAATTGAG	Gvszgh8
ACCTCCTGGCACGAGAAGGGCGG	Fzwc6
GGATATCACAGGCTAAAGGA	Uhaumof86
GAACACAAAAACTGGTCGG	Juast
GGCTTCCTATGAAAGAGAAG	Jbxdtih9
GACTCCCTGCTGCTAGAGAC	Rrqo0
CTCCAGCGATGTAATCGAAA	Qeim
GTGGTGGTGGTTGGAGGCCG	Mdzg18
GAAGAGGACACTTCTGATGG	Juast
ACAGAACAGTGTCTTGATGG	Nhwzt
CAGCTCTTCGTGATCGACAA	Eflp15
CATCAGCTGCTTAAATTTGC	Juast
TCAACTTCAATAACGCAACT	Wuacgws
CCTGCCTGTCCAGCCCGGTG	Dsfwptx2
CCGGGCTTCAGGAATAAAGG	Wotwb
CATTGTTGAGACTGTCCAG	Hstki
CAAAGAGGAGAAAGATGCCG	Jzaqrh
AGGTCAACTGCGCACAAGG	Zjrw
CCAAAGACTTGGACACCTAG	Ndxe95
CTATCACAGGGCGATCAAG	Mdzg18
GGACAACAAGCTCAAGACCG	Uieqtrb
CGAATACTGCTACCGCGACG	Aonu8
CTGTGTGAAGATCTTCTCTACGG	Yaczvxn
TCAAGGCCGAGTACAAACGT	Lbujspo20
CTCACCGGCCACAGTTGCAG	Kmlp4
CACAGTGGATGAGTTCTCGGGGG	Juast
GCATTTCAACGTAAGTGTG	Mdrpz7
TGGAAGATAGCTCCAGCGA	Hwxp30
AGGGTGTGCAGCTTTCGTTG	Ldlb35
AAGACGTTGAACAGCTCTTC	Fmhctyb
CCGCCTCTGTAGGTTCTGTC	Ldlb35
AATCGCTGGAACCCGGGAGG	Qeim
GAGGCCAAGTGATAACCCAGCGG	Zexgq29
TCACCAATTCCAGGGCTCGC	Doqu
GCGGAAGACCCCGTCGGCGA	Jbxdtih9
ATACTCGGTGACGATGTAGA	Fxsq75
GCTACGCGCGGAAATGGCCG	Ndxe95
TTTCTAGGAGAAGACTGGAG	Eflp15
GAGTGAGCAGGGCTACAAA	Rhbmcui
CATCAAAAGGGAGGCAGTA	Xlgrb0
AGGTTTCGGATCATTCCGAA	Fxsq75
CGTGCTGGTGGTGCTGCTGG	Mrveio
GTGTCATAAAATACCAGTGGAGG	Zcukgzl94
CCAATACAGAGGCAGAGTCC	Qysdhnf8
AGATCTATAACACAATTCGT	Yaczvxn
CGGCGAATCTGAATGCGGTGCGG	Dwklva21
TTGGCCACCGCAAAGCACTGTGG	Kmlp4
AAGCCTGGCCTCGGTCCCTG	Mwhdrs5
AGGCTCCCAGAGAAATGAG	Xvwuz
CCGCTTCAGCCGGAAGGAGA	Kwznvd80
CAATGGTAGCAGCAGATGC	Qldbrk39
ATGACTACCGTGTCAGCGG	Sjlkqgb
GATGCCGTCACGTACCTCGCAGG	Rtfgbkn1
ATGGCATGGCTTCCTCCGG	Sjlkqgb
GGACCCGTGAAAGAGCTGGTCGG	Wuacgws
AGCTGCAAGAATCATTCAG	Zjrw
AAGAGCCTTGAGAAGATTCT	Meuxsq3
CCAATGTCCAGCTTCCACCG	Rzlpq38
ACCCCAGAGTCTCTCCGACAGGG	Itvfs
GATGACGCACAGGTTCAGGA	Rtfgbkn1
CCGCGACTCGCGCTCGGGTT	Wotwb
AACTGCCTTCATCCATCACC	Qeytcm36
CAAGGGTGTTTCTCCATCAC	Dsfwptx2
AGCTCAGTCCACTGTGTTGA	Vkxipvz0
GGGCATCCGACTCTTGTGAT	Kwznvd80
TCGGTCCTCGGCGGATCAGG	Beiwtf
ACTACAAGGGGATGGACAG	Sctgkpj1
CCACATCTTTCACACGAGGT	Zbzwj9
CCTTACAGATGAAGAAACTG	Yaczvxn
AGAAGCCTCCTGGCAATCTC	Ffptj62
AGCGACAAAAAATAAAGCT	Itvfs
ATGTCCCTGAAGATATCCGG	Wotwb
TACTCAAAGACGCCTGTACC	Mwhdrs5
GGGAACCCTCAAAGGTGGGG	Jbpa76
GCCACCCTGGCTGTGGAGA	Qeim
CTAGGTTAACACCTAAAAT	Sctgkpj1
AAGGCCTCTGTGAAAGCTC	Uieqtrb
TGGAGCTTCAGGCTGCCCG	Hrazgjq47
GGGTCTCATAGTCCACACAG	Vfxncrp0
TGACCACAGGCTCACCTCG	Nisw8
ATTGTAGATAAAATAGACG	Fmhctyb
AGGGCCGAGTGGTGTGGAA	Zjozemv6
ATTGTATCATGGCTCCGTTG	Itvfs
GGGGATGTAGTAGAACAGTGAGG	Ewlc8
GTTCCGATTAAGAGTTCCCA	Hpqy6
AAAGTGTCAGATCCAGACTG	Sjlkqgb
AGTGCTGCAGTACCATGCCA	Wsyazg
AAGGCAGCGGAAGCTCCTGG	Ndxe95
AAGTATCGAGAATGGATATG	Xvwuz
TGCAGCCACGGCTTGAAGTG	Yfijg5
ATCTGCAACACACTCCAGCC	Ewlc8
TCAAGGACCCTAATGGCCAC	Yaczvxn
AGTCTCCAAGATTGACAGC	Kwznvd80
CCAAAATGAGCTGTAAGAAG	Jsakmu
GGTGGACGTGGCGGCCCAGC	Qxwg6
GAAGCTGTTGTACATGAAG	Rudpz73
CCGCTGCAGGAGCCACAAGA	Rzlpq38
AGGAAATGGGAGGTGTTCCC	Sjlkqgb
GTGAACTGTCAATGAAGTGA	Rhbmcui
CCTCGTGGGACACAACCCTGCGG	Wsyazg
TTCGGCTTCAGCTTCAGCCC	Ideqaw
TTTCTAAGGGAAGCGACATC	Uhaumof86
GTCTGTACAGAGATGTGATG	Jcjgmqa90
GCCGCATTCCACGCAGGGCG	Sctgkpj1
GGCCACCAGCTTGGAAGCAG	Gayutvo78
TGAGCAATGACACTACATGTGGG	Rzlpq38
TTCCTGCCTGCCTGGGTGAG	Mrveio
TCCATTGCAATATTCAGGG	Ideqaw
GTCCTATGGGTGTAAATGG	Eflp15
GTCAGCAGACCATAAGAATT	Gvqti8
GGTGTGTTGGCCAAGAGCGC	Eflp15
TCTGGTTGTAGATTATCCTG	Ewlc8
TCCCTCTTCTGTGCTACTC	Lbujspo20
GTCCAGCAAGGAGACCCAG	Wsyazg
AAATTCGAATCCCCTGACAA	Vfxncrp0
TCCTCCCGAGGTTCGCTGAG	Hpqy6
AGAGTAGTTAAACTCAACGGTGG	Dwklva21
GAAGATGATGGAGTAGATGG	Gtjd
CTCCTACCGAGTTCGAGCCC	Vkxipvz0
GATCTGGTACTTGGTATAG	Doqu
GTACTGACCGCCTTAGATGG	Pzyiw8
GGTCAATGAGGATGACGAAG	Qldbrk39
CAGCATGGCCACCAATGACA	Qxwg6
TGGATAAGCACTTGGAATCACGG	Rhbmcui
TCAGAAGGACTTCAAAGCG	Jbpa76
GCTGCTGCAGCGGCAGGTGC	Mrveio
GCCCCAGGCCAGCAGCAAG	Ideqaw
GGCATAAATATAATCCACTGGGG	Kgfdvu
TCACTTAGGAGACCAAATAGTGG	Hrazgjq47
TTGCTGCTTCTTCTTTGGCG	Zcfxwy
GTATCAAGCTCATCACCGA	Bqtk19
GTTCCACAGCGTCTGCACCC	Xlgrb0
TCACTGCATGAATTTACACG	Mdzg18
TAGCTGCCATCCCACTACCC	Mwhdrs5
TTGGTCCCATCTTGAAAGTC	Sctgkpj1
ATGGTCAGGGGTGAGATGTGTGG	Pzyiw8
GGACTTAGTCCAGGAACCGCTGG	Fmhctyb
TTCAGTTCCGGTGTCTCGCC	Doqu
ACAATCATCAGCTATCTACC	Beiwtf
GAGGAGGCGGAGCGCTCCGA	Qxwg6
ACAAAGAAATCAACAAAAG	Mdzg18
TTACACTGATCTGGAGCTGA	Itvfs
TTGTGGGAAAACCTTCCATC	Juast
CTCATATACGTGGTAGAGGG	Kwznvd80
CTTTGTCCAGCTTGCGTGAC	Gtjd
ACATTCTCGATGGTGTCACT	Wuacgws
AAAAACAAGAGAAATAGAGTTGG	Vkxipvz0
CTTTCCCCACCAAATTGGGT	Jbxdtih9
TCAGGTTTGGATGCTAACAG	Rudpz73
GTCAGAGCACCGGAAGTTCC	Hpqy6
AAACAAGGGCATCATCACCA	Mdrpz7
GGGGCAGCCATCTCCCAAG	Ldlb35
GGCTCACCATGAATTCACTT	Zcukgzl94
GCTCGCGGCCGAGTCAATGG	Kwznvd80
ATATATCCCAAGAACACGAAGGG	Wwtxj
GGGAATGCCACGGACCACGA	Zcukgzl94
AGACTGCACCAGTGTAGCCA	Qeim
CCAATCACAGCAAACAACG	Qmin
AGACGGTCCCCGCGAGTTCT	Mdzg18
GAAGCGCCCATCCTCGTGGTAGG	Pzyiw8
CCTGATTCGAGCAGGCGAGA	Meuxsq3
GGAGTAAGGATCTTGCGACTGGG	Kgfdvu
GGATCTGCACAATCTGCAAG	Ideqaw
GATGAGCCAGGAGTGCCAGT	Kgfdvu
GGTTTCTGGAGAGTCGCCGA	Mtim
GTGCGATCTCCTTCACATGC	Kwznvd80
TACGCGGAGTGGTTCGCCA	Gtjd
CTAAGAACGATGTCAGCTG	Fxsq75
GAGACTAACAGCCCCTTGGG	Jcjgmqa90
CCATCCACAAGAATCTGCCA	Ideqaw
TAGAAGATGAAGTGACCCAG	Jzaqrh
TGGCGCAGCACGTCGGCGGC	Juast
TCAAGCAGTATGGAGCGCCC	Gvqti8
GGAGGACGACTCACTCTACT	Rrqo0
GTCCATCTCGAAAAAAACGT	Qoeg
GCAGTTTGCTCCATACCAAA	Citbe6
ACAAGACGGACCGGAACCAC	Xlgrb0
GCACTCATGGAGAAAACTGGTGG	Hpidfa
GGATGCTACTGCTGGTGCCC	Rpun
GTTACCTAGAAGTGGACTA	Wsyazg
CAGAAGTTTAAAGACCACGTTGG	Zcfxwy
ATCTGTTCACTCTTGTGGGC	Hwxmbru
CATGGATACCGTCTCTGTCG	Hwxp30
GCTGCCCTGGATGCGGGAAG	Rpun
GATGCCTTCAAGAGGACCTG	Gayutvo78
GGCACAGCGGAGAGAATTCC	Qoeg
GATGAGAAGGACTGTAGAA	Qeytcm36
ATATACAAGACGCCCAGAAG	Xvwuz
GAGCCCTCATTGATCGAAGC	Vkxipvz0
GACACCAAAGGCGAACACC	Itvfs
GGAGCTGCTGATGCAGACAT	Ffptj62
GCAGGAACCTCCAACGAGG	Jcjgmqa90
CATGATGTACGTGCTCATTG	Qmin
TGGAGTCTGCACATTACAG	Aonu8
AGGTGTGTATGAGAGACTGG	Zbzwj9
GACAGTCGCCGAGACTCGG	Mdzg18
GAAGATGTTATCCACAGCCT	Nhwzt
GCCCCACTCACCCGAGCCG	Vzjlgte58
CTGTTAATGCCAAATCAGG	Gcarf81
AAAGCTGCAGATCAGAGGCGTGG	Jsakmu
TCATCAACAATGTAACTGACGGG	Qysdhnf8
AGATCAAGCTGTGTGACTTC	Doqu
GAGCTGCAGCAACGTTCGGT	Kmlp4
AGTATCAAAGAGAGCAGCGT	Wotwb
GACATTCTGGATGGCAGAGG	Fzwc6
CAAGAAGTTTGTTCGGGGA	Lbujspo20
CCCCAGAAGGCATCACCAG	Ymhtq
TCTCTCCGACGGATTGAGAG	Jbpa76
AGTTACCTGTAACTCAGGAA	Zjrw
GAGAGCCCTGTGAGAAAACG	Pzyiw8
TGGGGCCCCAGCCTGCACCGTGG	Rrqo0
CACAGGCGCCTACAAATCG	Gtjd
GCCGGAGGAGGGCGAGAGAA	Ffptj62
TCACAAAGTTCTTCATGTG	Mwhdrs5
CATGAAGATTGCCATCGTT	Rudpz73
GCTCCTGCTGCTGCAGGGCT	Zjozemv6
AGGGCCTGCGGAAGAGGCGC	Zcfxwy
CAGCAAAGATGGCTACAAAG	Rhbmcui
AGGAAGCCACGAGCAGCCGT	Enht2
TCGCTTCGTGGAGAATGGC	Hpidfa
TCCCCTCACCGGGTCCTCAA	Ffptj62
TGCCTTTGCATACCAGATAG	Yqhuvtw4
TAAGAGTGCCGTAACAACTGTGG	Jsakmu
ACAGTGACGAGGAGTGGCGG	Pzyiw8
CAAGTATGTATATAAATGA	Gvqti8
GAATATTATCATGCTAACG	Jcjgmqa90
GAAAACATATCCATTAAATG	Uhaumof86
ACTCCGATACCAGATGCCAC	Zexgq29
TGCCCTCAGTGGAGTGAATG	Citbe6
GCCGTGCGGGTGGTGGACTT	Heko15
AGAGTCAAAGAGGCCCCAG	Wyatj5
GACAGCCTTGAATCTCACCA	Mwhdrs5
AAAGATAACTGTTGACCCTG	Itvfs
AGGCCGAAGAACACACACG	Xvwuz
CTGGCACAGCTTCGCAGACA	Xvwuz
CGGTGCTGAGGAGCGGTCCC	Bxltvfh82
CACGCGCGTGAACTTCACTCTGG	Doqu
CGCCGGCCCTCTGCCCTCCG	Ozxvfe04
AACTATCCATCGAAGAAGCT	Mdrpz7
TAAAATTCGAGAAAAAACAC	Nhwzt
GATCCTGGCATCATATCCGG	Gtjd
CGAGAACCAGGCGAGCGCTG	Wyatj5
GCGCCACAGCTCTCTCCCCA	Xlgrb0
TGGAGCGTCAGTATCAACTGCGG	Gsle9
CGTGTGCATAGCCTTCAAAGAGG	Jzaqrh
GGACCCCAAGATTGCAGACC	Fmhctyb
GAAGAGCCCAGACCTCAGCC	Ozxvfe04
CTTGCAGTCTGGTCTTACCA	Uhaumof86
GCTGTGTGGCACAAGTGCCT	Rudpz73
ATCTCACGAGCCCCACGGC	Ldlb35
CTCACTAGAGTCAGGGAAAC	Gsle9
GTCCCATATTGAACTCGAGT	Vfxncrp0
TACTGTGAGAAGCATGCCC	Vfxncrp0
TCACAGACATCCCATCGAAC	Rhbmcui
CTTTGTGGGTCAAGAGCCAT	Hwxmbru
AACGTTTCTGAACCCCGCTGTGG	Dwklva21
TCTCCACGTCCAGCCCGAGA	Fmhctyb
TGCACAGGCAATAAGCACCT	Ggfes41
TTTTCTATGTGTTTACAGG	Zcfxwy
GGAAGCTACAGGTTACGGC	Ldlb35
CAGGGTCGTTGAAAGTTGCA	Heko15
GATGCCCGAGCCTTTGACA	Qoeg
TGTGAATGGGCATCACCACTGGG	Gcarf81
GGAACTGGTGGACGGAGAGG	Dwklva21
AAAACGCCGACTTGATATTG	Yqhuvtw4
TTCCAGTCCGATTTAAGCGG	Jbxdtih9
CTCCTTCCTTCTTCTCTGTC	Bqtk19
AAGATTTCATACCATAGGCT	Eflp15
GTTCCTGCCACTCTGGCTG	Ewlc8
TACCTAATGCCGTTTGGAAC	Mtim
TGCAAGCTGAATGTGGCAG	Rtfgbkn1
TTAAAAACTACCTGCAATA	Kgfdvu
AGCTGCCGTTCGGCTCTAC	Gayutvo78
AATCACTACCAGGTGACTCAAGG	Nhwzt
GGAGTAACTGATTTACACAA	Pzyiw8
TCTCTTCCCAGAAGTCCCAC	Kwznvd80
TGTTGAGCTCCCAAATTCAC	Vzjlgte58
ATTCAGGAGTTAACACTGCT	Doqu
GAGACGGAGAAGAGTACGAG	Kgfdvu
CTTTGTAGCAGCAGCCTTCA	Juast
ACACGCCACATTCAAAGCCA	Enht2
CAGGACTGGCCTTTTGATGA	Mrveio
AGGTCAGAACCAACGGCGC	Jbxdtih9
CTCTAACTCCTGAGTCCAG	Gsle9
ATAGGCCGAAGCTCCAAGGC	Gvqti8
CTGCTTATAGAGCCACAACAGGG	Kwznvd80
ATTCACGGTGCTATCTATGC	Wyatj5
GATCACTTACCTTCTCAGG	Juast
GCTCACTGCAGAAATGCAC	Aonu8
TCTGTGGCACATTCCGACC	Jcjgmqa90
GATCATCTTGAAGCGAGCGG	Eflp15
TTCAGCAAACAGACCATCG	Qmin
GTACCTGTCCCGGGTGAAGA	Aonu8
GCAGAGAGTTAAGAAAGACG	Husam49
CGTCCCCTGCTACAAGCCA	Jcjgmqa90
TGCCATGTGCAGTGAACCCC	Jzaqrh
GCCTGAGGGCGCCGCTCGGAGGG	Citbe6
AGCAGGACCCCTACTTGCTA	Xvmyqf
TATCAGCCTGCTGCCGAGCT	Urva39
CTTAGGCTCCTGTCCCGGG	Qmin
CTCCATGAGATAAGCCATCG	Dsfwptx2
AAGAAGGTGTGTTTACCGTG	Gvszgh8
GAGCCACGCGGCAGGTCCAG	Uhaumof86
CCCGGGACAACTATAAGGC	Wsyazg
TCATTAAGCAGCTTCGAGTC	Rudpz73
AGAGGCCGCTATGAAGGAGT	Eflp15
AGTTCAAGTAAGAAAGACG	Hwxmbru
GTGATGTATGCTGTGGCCCT	Zjozemv6
GTAAACTCCAAGAAATTTCA	Jcjgmqa90
TGCTCCTTGCGTTTCAGTGG	Gtjd
ATGTTTTTGAAGGCGGGCAG	Citbe6
AAACCCACAGCCTGGGTAGCAGG	Gayutvo78
GGTTGTGCTATTCTATGCTG	Uhaumof86
CCTTCGGACGGCTGCCCCT	Ymhtq
TATAGGGAGACACTGAAGCC	Juast
TAAGCTGGCACAGATGGAAG	Qysdhnf8
ACTTCCTATGGTATTCAGAA	Zjrw
TGGCGCACTCCCAGTTCATGAGG	Gayutvo78
GTTTCCTAGTTACAAAGTGAAGG	Gvqti8
CCTGACTGGAATGAACTGCCTGG	Hwxmbru
TAGATCAATGGAAGACATGG	Vzjlgte58
CATGGACGATGACCACCAG	Jzaqrh
CAACCGCCCTACCTGGCGG	Wotwb
CTTCGTAACCTAGGACGTG	Zjrw
GCCACGGTGCCACTGCAGAG	Rudpz73
CATTCCTTATGTCAAAGCAC	Zjrw
TGACGACGAGGGCACCGTGC	Rkcfows80
TGCGTTCGTCGGGGCCTGTG	Qysdhnf8
GAGTCAGCCGGCAGATCCAG	Xlgrb0
AATCACGAACTTCCTAGGTG	Xvwuz
GTCACTCTCCAGTTTGCAA	Heko15
GACTACGAGTTCCCTGAAG	Heko15
GCTAGGATGAAAATGAGATG	Gtjd
GCCTCAGAGGGAAGAGACAT	Dwklva21
GTCTCACCTGAACTAGGCC	Pcauhol9
TACTTGACACTGCCTGTACT	Pcauhol9
TCTGGACAAACTCATCAAG	Kgfdvu
ACAGATGCTGAGAGAGAGGG	Sjlkqgb
ACTCTCCCGGTCCTCCTCCA	Rrqo0
GGAGTACTCACGGGTAGCCA	Gvszgh8
TTCATCTGAAGATGAAGGG	Citbe6
GCACAGGGGGCCCACAATGTGGG	Rudpz73
CAAAGCAGGCCAGAGCACGG	Dwklva21
GTACATATGCAAGCGAAATG	Kmlp4
GGTGGAGAGCAACTCCGATG	Kwznvd80
ATCAAACCATCATGCGGAAG	Zexgq29
ATGAAGAAACTGAAGGAGCG	Rrqo0
TTTGTTGAAAATTCAGTGG	Zexgq29
ACATCGCCTGCACAGAGCGGAGG	Zjozemv6
CCCTCGGAGATGGTGATCC	Qeim
GGTTCCATCTATGCCGAGGC	Hwxmbru
GGAAGCCATAAGCAATGGAG	Zcfxwy
CTGTTGCCACAGCCACAGC	Zjrw
GGCGCACACGGGCCGTCGCT	Hrazgjq47
CTCCTTACAAAGGTCAACAC	Heko15
ATCTAACATGAAAAAGGCTT	Nisw8
AGGGAAGAGATCTTCTACTG	Rhbmcui
TATGAAGTTAGATTTCACTG	Xlgrb0
GCCTTCACCTTGGAGGACAA	Kmlp4
CAGCGAACTAAAGAAGAAA	Hpqy6
ATCATGGCGACGGTTCTCGTAGG	Mrveio
TCTACCTCCTGCCGGGCCTT	Husam49
TGCCGTGCGGCGTGCTCGA	Rzlpq38
GACGGCCAAGTGTGAGCAGC	Rudpz73
GAATGTAAGATGCAAAGGG	Bqtk19
CATGGACCAGAAGGCTCGGG	Husam49
CTCACCTGATGCTTTGTAAT	Mdrpz7
ATCAGCTTCATTACGTGCAC	Husam49
ATCGATGAAGGACCGGATAT	Dsfwptx2
TGAGCAGAACGCACACATGGAGG	Pzyiw8
CTTACAGGGAGCTCACTCAG	Zjrw
CCCTGTGACATACTTTGGAG	Pzyiw8
GGTGACCCAGGCCTACACAGAGG	Mdzg18
GCAGAAGTAGCAGGAAGGGG	Meuxsq3
CAATGGTGATCATGGAATGG	Rzlpq38
AACTTCAGCCTGTTTCACTGTGG	Eflp15
GTTTCAGGCCGATGTACAG	Kgfdvu
CAGGAAATGGCTACAGAAAG	Hwxmbru
TTGGACCAGGAGCCGGGAGC	Ggfes41
AGCGCCACAGAGCTTTCAG	Vzjlgte58
CGAGTCGCAGCTGTGCACGC	Hpqy6
TTGCGCTTTGGGATCCTGAT	Vkxipvz0
TCTTTCCACAACCCACAGG	Hpidfa
ACAAAGGAACCTTCGAGTCA	Husam49
CAAACTCACCAAAATAGGG	Ideqaw
CATTGTGATATAGCGCTCAATGG	Zbzwj9
GAAGGGCAGCCAGCTCCTGA	Uieqtrb
TTAAGGAAGGCCAAGGCAG	Fmhctyb
TTTGCAGACAACACTTTCTC	Ffptj62
GGCGGCCCCCACCCCAGGTA	Mdzg18
AGCCTGGTGATGAGAAATGACGG	Sctgkpj1
CAGAAGGCCAAACAGGAAA	Pzyiw8
GTCGCTCGGACTGTAGTGGA	Zcukgzl94
CCAGGGCCAACCCTGAGGG	Vzjlgte58
GGTGTTCTATGACATCAGCA	Hwxp30
AACTGGCCATCCATAATCGAGGG	Rkcfows80
ATACCTGCCCAGGCTGTACC	Mwhdrs5
GCTAAATGCCAGCCCATGTC	Gsle9
ACGGAATCCAGCACTACAC	Juast
CTAACCGGTGGGCGGCCCGCCGG	Meuxsq3
ATACCAAGAGTAGGAGAGCG	Fxsq75
TCAACATGATGTCGTTATTG	Wwtxj
TCCTGGTGGCCCTTTGTTC	Qeytcm36
GCTCGGGGAAGACATCCTCG	Hwxmbru
CGTTTCGCCGGTTCCACTGT	Qoeg
CGGAAGCTCATATACTACACGGG	Qeim
GACTACCAGTATGACACCCC	Gtjd
CACTGACTACTTGGCACCG	Dwklva21
GAGGGCGCCACGTAGCACACAGG	Nhwzt
CACCAAAAAGGTAACGTGCC	Kwznvd80
GGTGGACACAATCCCTCTGA	Ffptj62
CGTAGAACACAAGGCTCAGC	Kmlp4
AGTAAACCAAGATTTCTATG	Ozxvfe04
CTGAATGGAGAATTCTCCCG	Meuxsq3
GTCCAGCTCGAATATCTCG	Xvwuz
GTTCCCCAGAATGCCAAGCA	Mdzg18
AGAACGGCTTCTCATCGCG	Hwxp30
ATGATGTTGGTGGTGTTCAA	Xvmyqf
ATGAGTAAGAAGCAGGAAG	Ffptj62
ATCAATTACCTGCTTGATGT	Hwxp30
AAGCTGGTGTCTCTGGGGCG	Qysdhnf8
GCCAAACTTGGTCACACCCT	Nhwzt
GCATTTTGGAGAATGGACCGAGG	Sjlkqgb
CGACTGGAGCGGTACCCAA	Hwxp30
CAACATAGCCCACTCCTCCA	Qmin
AGGTCTAGAGAGCAAATGAAGGG	Wyatj5
CACCAGCAAATATCAACAT	Citbe6
CTCGAGGGTGCGCGTGAGGC	Ewlc8
ATTTCACATACAGACCTGA	Mtim
GGGAGTTGAATCAGGCCGTG	Hrazgjq47
GAACAAGGCAGCAAGGACAG	Ymhtq
CAATGTGGAGAAGGAACGAG	Sctgkpj1
CAGAACGCAGCGAAAGTGA	Jsakmu
GAGGAGAGAAGAGACAAATA	Wyatj5
CACCACCCAAAGTAAGTGG	Xvmyqf
GCAGCTACAGCAGGCATCAT	Hwxmbru
CTCTTCGTTGAGCACTGCAG	Meuxsq3
GGCGGCAGAGAAACTCACCCAGG	Dwklva21
CTGTACCCACTGCCTCCAG	Jzaqrh
AAAAAAAAAAAAAAAATCCC	Ndxe95
AGTGGATATCCAAGAAGCAA	Qxwg6
CCCCCTTAATGCACTCAAG	Gayutvo78
GATGCTGTGACCTTCGAGG	Wwtxj
ACACCTCGAACACCTCGCGCAGG	Hstki
CTATGACCGGTACTATGAG	Rudpz73
ACTTACTCTGTGACATACAT	Ldlb35
AACCGGTCCACTGGGAAGAA	Qysdhnf8
CTGCAGCCAGTGAAGAAGCG	Qoeg
GGGCCTGGTAAATCATGCCG	Jzaqrh
CTGCAGGCAGGCTCCGCCA	Qeim
TGGGGAGATACCCACACGC	Rkcfows80
TCCAACAAGCTATCATCTAT	Enht2
CTTCGCCGTTAGCTTCTACC	Beiwtf
TCAGCCACACTCACCCATCA	Uieqtrb
AAGCCTCGCAGCCTCCGGGTGGG	Qysdhnf8
GAGCAGTGACTCCTCCACCA	Hxczgaq0
GTCGCAGAAAAGTATCTTAGAGG	Dsfwptx2
CTCGGGACTGAGGTACTCAGAGG	Meuxsq3
GTTTATACCAGGAACCATA	Hwxmbru
GAAGATCCCGTTCATCAGGG	Ggfes41
GAACGCCTGGCCGCCCGTGT	Gtjd
CATCGCCTCCCCTGTAGACG	Nhwzt
ACCTTGACAATGAATTCCGA	Rsbq0
ACATCATTCACTGTGAAGTC	Gtjd
CCACGTGAAAGTGCACACGA	Wsyazg
ATGTGCCAGAACTTCCCTGC	Ozxvfe04
AGTGAGAAGAACTCCCGCAT	Gtjd
AGCCACAGGCAGTCCCAGCG	Itvfs
CTCCCTGACAGGAGCGCCAG	Rzlpq38
TTCTCCTTCTGCCTTTATCC	Jbxdtih9
ACGAACGCAGGACAGTTCCGCGG	Wuacgws
GGGAGGCGTAGACCATATAG	Rsbq0
CGTTCATGCCAAACTGGTGC	Jsakmu
CAGTGAGGGATTTACTGAA	Rudpz73
AGCTGATTACATAGACGGAA	Zjrw
TACCTTACCGAATATGTTAG	Lbujspo20
GATTTCTGACCTTTAGCCGG	Qmin
AGGTTATCTTCACAGTGCCT	Uhaumof86
GAGCTTGAACACGTTTTCT	Qeim
AGAAATTTATAGCTGGATTC	Aonu8
GACCTACCTTATATGGACAG	Ndxe95
CTCCCATGAGCGAGGACGCA	Ldlb35
GCTGCTGAGCGCTCGGCGCC	Xvmyqf
AGAGCTAGTGGGTAAGTAG	Vfxncrp0
CATGCTGCTCATTGTAGGCC	Xvwuz
TCTCACCTTGGATGGCTCGGCGG	Kmlp4
ATGCTTCAACATCTCAGGT	Hwxmbru
CAGCCGGATGTCTTTGAGCT	Juast
CAGACTCTTGGCCCTCGGAA	Zbzwj9
TGGGTCTCTCAGCTTTGCA	Lbujspo20
ATTTTCCGCGAGTTCTTTG	Qoeg
GGCGTAGAGCGGCAGCACGG	Ewlc8
GGGGAGGGCGCAGAGGCAGT	Mdrpz7
GCTGCATCCTTGTATTGCAG	Citbe6
CCTGTACGCCTTGTGCCGCC	Qmin
GGAGAACTCAACCCCGATGG	Ewlc8
CAGCCATCACGGATAGCACT	Ffptj62
CAAGCTGGAAGGAGAAAAG	Aonu8
CTTACCGGAGAAAGTTTCGA	Qeim
TCTTTTCGGCAGGTGATCG	Pzyiw8
GCAAGGCAGGAGCCACACGT	Qldbrk39
CATCACAGCGCCAGGACAGG	Fmhctyb
GGGGACCTGGCCCACGCCAA	Hwxmbru
AAGGAGGGAACGCCGCCTGA	Xvmyqf
GATGTACGACCGCGCTGCAG	Ndxe95
ACGCCCAGACCGCAGAACTG	Sjlkqgb
TGCAGTTTACTATTGCAAC	Pcauhol9
TAAAAACGTGAATGGCAAGGAGG	Rsbq0
CCTGGTGGATCGTACAAGCC	Jsakmu
GGGGAGAGAGAAAGGTGAGG	Ffptj62
GTGGTGATCGACCTGTTTC	Fmhctyb
GCAGTCACCGCATCGAGACG	Qeytcm36
